11111111111111111111111111111111111111111111111
101001010010000111111110101001010000C0000000E01
101001001010101011111111001001010000000C0000001
100000000C00C00011111111000000000C0000000000001
100000000C00C000111111110000000CC00000000000001
100000000C00C0001111111100000000000001000000001
100000000C00C0001111111100000000000000000000001
100000000C00C000000011110000000000000C000000001
100000000C00C000C000000000000000000001000100011
100000000C00C000000011111000000000000C000000001
100000000C00C00P01001111100000000000CC000000001
100000000C00C0000111111110000000000000000000001
100000000C00C0000111001110000000000000000000001
100000000C00C0000111111100000000000000000000001
100000000C00C0000111011110000000000000000000001
100000000C00C00001111C1110000000000000000000001
100000000C00C0000000000000000000000000000000001
11111111101111111111111111111111111111100001111
100000000C00C0000011111111000000000000000000001
100000000C00C0000011111111000000000000000000001
100000000C00C0000011111111000000000000000000001
1000CC000C00C0000011111111000000000000000000001
100000000C00C00000111111110000000C1000010000001
100110000C00C00001111111110000CC00000000CC00001
1CC000000C00C0000C1111111100000C1C000000C000001
11111111111111111111111111111111111111111111111